{
  "level_id": "f44ebb0a-30a0-43ca-9260-4cb08dd89d33",
  "color_columns": [
    [8, 7, 5, 9, 7, 7, 5, 9, 7, 5, 8, 5, 4, 4, 7, 9],
    [7, 8, 9, 4, 8, 5, 9, 7, 4, 9],
    [8, 7, 7, 8, 4, 5, 5, 5, 5, 5, 7, 5],
    [5, 9, 7, 8, 7, 8, 7, 4, 5, 4, 5, 4, 8, 5, 8],
    [7, 7, 5, 4, 7, 9, 7, 8, 5, 7, 5, 8, 9]
  ],
  "bobbin_grid": [
    [7, 5, 8, 7, 8],
    [9, 9, 7, 5, 7],
    [5, 8, 5, 4, 8],
    [7, 4, 5, 5, 4],
    [9, 7, -1, -1, -1]
  ]
}
